w w w w w w w w w w w w w w w w w w w w w w w w w w w w w w w w w w w w w w w w w w w w w w w w w w
w p n i n p w w w w w w w w w n n p n p w w n p n p n p w w w w w w w w w w w w w w w w n p i p n w
w n w w w n w w w w w w w w w p w w w n p n p w w w w n w w w w w w w w w w w w w w w w p w w w p w
w p w w w p n p n n p n p n p n w w w w w w w w w w w p n p n p n p n p n p n p n p n p n w w w n w
w n w w w w w w p w w w w w w p w w w w w w w w w w w n w w w w w w w w w w w w w w w w w w w n p w
w p n w w w w p n w w w w w w n w w w w w w w w w w w p w w w w w w w w w w w w w w w w w w n p w w
w w p n p w p n w w w w w w w p w w w w w w w w w w w n w w w w w w w w w w w w w w w w w w p w w w
w w w w n p n w w w w w w w w n w w w w w w w w w w w p w w w w w w w w w w w w w w w w w p n w w w
w w w w w n w w w w w w w w w p w w w w w w w w w w p n w w w w w w w w w w w w w w w w p n w w w w
w w w p n p n p p n w w w w w n w w w w w w w w w w n w w w w w w w w w w w w w w w w w n w w w w w 
w n p n w w w w w p w w w w w p w w w w w w w w w w p w w w w w w w w w w w w w w w w w p w w w w w 
w p w w w w w w w n w w w w w n p w w w w w w w n p n w w w w w w w w w w w w w w w w w n p w w w w 
w n w w w w w w w p n p n w w w n p n p p n p n p w w w w w w w w w w w w w w w w w w w w n w w w w
w p w w w w w w w w w w p w w w w w w w w w w w n w w w w w w w w w w w w w w w w w w w w p w w w w
w n w w w w w w w w w w n p w w w w w w w w w w p w w w w w w w w w p n p n p n p n p n p n w w w w
w p w w w w w w w w w w w n w w w w w w w w w w n w w w w w w w w w n w w w w w w w w w w p w w w w 
w n w w w w w w w w w w w p w w w w w w w w w w p w w w w w w w w w p w w w w w w w w w w n w w w w 
w p w w w w w w w w w w w n w w w w w w w w w w n w w w w w w w w w n w w w w w w w w w w p w w w w
w n w w w w w w w w w w w p w w w w w w w w w w p w w w w w w w w w p w w w w w w w w w w n w w w w
w p n w w w w w w w w w w n w w w w w w w w w w n w w w w w w w w w n w w w w w w w w w w p w w w w 
w w p w w w w w w w w w w p w w w w w w w w w w p w w w w w w w w w p w w w w w w w w w w n w w w w 
w w n n p n p n p n p n p n p n p n p n w w w w n w w w w w w w w w n w w w w w w w w w w p w w w w 
w w w w w w w n w w w w w w w w w w w p n p n n p n p w w w w w w w p w w w w w w w w w w n w w w w
w w w w w w n p w w w w w w w w w w w n w w b b w w n p n p n p w w n w w w w w w w w w w p w w w w
w w w n p n p w w w w w w w w w w w w p w b j k b w p w w w w n p n p w w w w w w w w w w n w w w w
w w w p w w w w w w w w w w w w w w w n w b h g b w n w w w w p w w n p w w w w w w w p n p w w w w
w w w n w w w w w w w w w w w w w w w n p w w w w w p w w w p n w w w n p n p n p n p n w w w w w w 
w w w p w w w w w w w w w w w w w w w w n w w w w w n w w w n w w w w w w p w w w w w w w w w w w w
w w w n w w w w w w w w w w w w w w w w p n p n c n p w w w p n w w w w w n w w w w w w w w w w w w
w w w p w w w w w w w w w w w w w w w w n w w w w w n n w w w p w w w w w p n p n w w w w w w w w w
w w p n w w w w w w w w w w w w w w w w p w w w w w w p w w w n w w w w w w w w p w w w w w w w w w
w w n w w w w w w w w w w w w w w w w w n w w w w w w n w w w p w w w w w w w p n w w w w w w w w w 
w n p w w w w w w w w w w w w w w w w w p w w w w w w p w w w n w w w w w w w n w w w w w w w w w w 
w p w w w w w w w w p n n p n p n p n p n w w w w w w n w w w p n w w w w w w p w w w w w w w w w w 
w n w w w w w w w p n w w w w n w w w w w w w w w w w p n w w w p w w w w w w n p n w w w w w w w w
w p n w w w w w w n w w w w w p n w w w w w w w w w w w p w w p n w w w w w w w w p w w w w w w w w
w w p w w w w w n p w w w w w w p w w w w w w w w w w w n w w n w w w w w w w w w n p w w w w w w w
w w n w w w w w p w w w w w w w n w w w w w w w w w w n p w w p n n n p w w w w w w n w w w w w w w
w w p w w w w w n w w w w w w w p w w w w w w w w w w p w w w n w w w n p w w w w w p n w w w w w w 
w w n w w w w n p n p n w w w w n w w w w w w w w w w n w w w p n w w w n w w w w w w p w w w w w w
w w p w w w w p w w w p w w w w p w w w w w w w w w w p w w w w p w w w p w w w w w w n w n p n p w
w w n w w w w n w w w n p w w n n w w w w w w w w w w n w w w w n p w w n p w w w w w p n p w w n w
w n p n p n w p w w w w n w w p w w w w w w w w w w w p w w w w w n w w w n p w w w w w p w w w p w
w p w w w p n n w w w w p w w n w w w w w w w w w w w n w w w w w p w w w w n w w w w w n w w w n w
w n p w w w w w w w w w n w w p w w w w w w w w w w w p w w w w w n w w w w p w w w w w p w w n p w
w w n w w w w w w w w w p w w n w w w w w w w w w w w n w w w w w p w w w w n w w w w w n w w p w w 
w w p w w w w w w w w w n w w p w w w w w w w w w w w p w w w w w n w w w w p w w w w w p w w n w w 
w w n w w w w w w w w w p n p n p n w w w w w w p n p n p n p n w p w w w w n w n p n p n w w p w w 
w w p n i p n p n p n p n w w w w p n p n p n p n w w w w w w p n p n p n p p n p w w w p n i n w w 
w w w w w w w w w w w w w w w w w w w w w w w w w w w w w w w w w w w w w w w w w w w w w w w w w w